NO ./textures/concrete_no.png
SO ./textures/concrete_so.png
WE ./textures/metal_we.png
EA ./textures/metal_ea.png

C 0, 51, 99
F 123,63,99

111111111111  1111
111111111111  1  1
100000000001  1  1
100010011101  1  1
10010001 101  1  1
101000001101  1 11
100000000001  11N1
111111111111  1111