NO ./textures/castle-wall.png
SO ./textures/castle-poland.png
WE ./textures/castle-poland-squares.png
EA ./textures/metal_ea.png

F 0, 51, 99
C 123,63,99

111111111111
100000000001
100010011101
100100010101
1010000S1101
100000000001
111111111111