SO ./textures/sims1.png
WE ./textures/sims2.png
EA ./textures/sims3.png
NO ./textures/sims4.png
DO ./textures/neon_broken_wall3.png
C 9, 24, 51
F 48, 27, 104

                                   11111
                                  1100011
                                 110000011
    111111111111111111111111111111000000011111111111111111111111
   11000000000000000000000000000000001000000000000000000000000011
  1100000000000000000000000000000000111000000000000000000000000011
  1000000000000000000000000000000000010000000000000000000000000001
  1000011111111111111111111111111100000001111111111111111111100001
111000111 11111111111111111111111110000011111111111111000001110001
100000001 10000000000000000000001111000111100000000010000000110001
100000001110000000000000000000001100000001100000000010000000000001
100010000000000000000000000000001101000101100110000010000000110001
10011100000000000000000000000000110000000110011000001100000111101111111111
100010000000000000000000000000001101000100000110000011110011100000110000011
10000000111000000000000000000000110000000110011000001  100110000000100000011
100000001 1000000000000000000000110100010110000000001  100110000000100000001
11110111111000000000000000000000110000000110000000001  100110000000100000001
  10001100000000000000000000000011010001011111100111111100110000000100000001
  10001100000000000000000000000011000000011000100110001100110000000100000001
  10001100100000000000000000000011010001011000100100000100110000000100000001
  10001100100000000000000000000011000000011100100100000100110000000100000011
  100011001111D111011111D11110011101000101100010010000010011100000110000011
  111111DD1110001000100000001001 10000000110001000000001001 11101111110011
     100000010001000100000001001 1010N010111001000000001001   101    1001
     100000010001000100000001001 1000000011000111100000100111110111111001
     100000010001000100000001001 1010001011000000000000000000000000011001
     100000010001000100000001001 1000000011100000000000000000000000011001
     100000010001000100000000001 1010001011000111100000000000000000000001
     100000010001000100000001001 10000000110001  100000000000000000000001
    1100000011D11111101101101001 1010001011101111100000000000000000011111
    1000000000000000101101101001 100000001 10100010000000000000000001
    1000000000000000101101101001 101000101 10100010000000000000000001
    1000000000000000100000001001 100000001 10100011110000111100001111
    100000000000000011111111100111111D111111011011  110011  110011
    11111111111111111       100000000000000000001    1111    1111
                            100000000000000000001
                            111111111111111111111